Date	Description	Amount	Balance
02/01/2025	Alice deposit	40000	40000
02/03/2025	Bob deposit	10000	50000
02/05/2025	Charlie deposit	22000	72000
02/07/2025	Diana deposit	5000	77000
02/10/2025	Eve deposit	7000	84000
02/12/2025	Diana deposit	8000	92000
02/15/2025	Eve deposit	13000	105000
02/18/2025	Diana deposit	15000	120000
