Date	Description	Amount	Balance
02/01/2025	Alice deposit	60000	60000
02/05/2025	Bob deposit	20000	80000
02/10/2025	Alice deposit	15000	95000
02/15/2025	Bob deposit	10000	105000
02/20/2025	Alice deposit	10000	115000
02/25/2025	Bob deposit	5000	120000
